//MAP CONVERTED BY dmm2tgm.py THIS HEADER COMMENT PREVENTS RECONVERSION, DO NOT REMOVE
"ac" = (
/turf/closed/indestructible/alien,
/area/deathmatch)
"ad" = (
/obj/structure/table/reinforced,
/obj/item/mecha_ammo/lmg,
/obj/item/mecha_ammo/lmg{
	pixel_y = 12
	},
/obj/item/mecha_ammo/scattershot{
	pixel_y = 18
	},
/obj/item/mecha_ammo/scattershot{
	pixel_y = 24
	},
/turf/open/floor/carpet/neon/simple/yellow,
/area/deathmatch)
"ae" = (
/obj/structure/table/reinforced,
/obj/item/mecha_parts/mecha_equipment/weapon/ballistic/lmg{
	pixel_y = -8
	},
/obj/item/mecha_parts/mecha_equipment/weapon/ballistic/scattershot{
	pixel_y = 8
	},
/turf/open/floor/carpet/neon/simple/yellow,
/area/deathmatch)
"af" = (
/turf/open/floor/carpet/neon/simple/yellow,
/area/deathmatch)
"ag" = (
/obj/machinery/door/poddoor/shutters{
	id_tag = "dm1"
	},
/turf/open/floor/engine,
/area/deathmatch)
"aj" = (
/turf/open/floor/engine,
/area/deathmatch)
"ak" = (
/obj/structure/barricade/security,
/turf/open/floor/engine,
/area/deathmatch)
"am" = (
/obj/structure/table/reinforced,
/obj/item/mecha_parts/mecha_equipment/weapon/ballistic/lmg{
	pixel_y = -8
	},
/obj/item/mecha_parts/mecha_equipment/weapon/ballistic/scattershot{
	pixel_y = 8
	},
/turf/open/floor/carpet/neon/simple/green,
/area/deathmatch)
"an" = (
/obj/structure/table/reinforced,
/obj/item/mecha_ammo/lmg,
/obj/item/mecha_ammo/lmg{
	pixel_y = 12
	},
/obj/item/mecha_ammo/scattershot{
	pixel_y = 18
	},
/obj/item/mecha_ammo/scattershot{
	pixel_y = 24
	},
/turf/open/floor/carpet/neon/simple/green,
/area/deathmatch)
"ao" = (
/obj/structure/table/reinforced,
/obj/item/clothing/head/welding,
/obj/item/weldingtool,
/obj/item/inducer/sci,
/turf/open/floor/carpet/neon/simple/yellow,
/area/deathmatch)
"as" = (
/obj/structure/table/reinforced,
/obj/item/clothing/head/welding,
/obj/item/weldingtool,
/obj/item/inducer/sci,
/turf/open/floor/carpet/neon/simple/green,
/area/deathmatch)
"at" = (
/obj/vehicle/sealed/mecha/combat/gygax,
/turf/open/floor/carpet/neon/simple/yellow,
/area/deathmatch)
"au" = (
/turf/open/lava,
/area/deathmatch)
"aw" = (
/obj/vehicle/sealed/mecha/combat/gygax,
/turf/open/floor/carpet/neon/simple/green,
/area/deathmatch)
"ax" = (
/turf/closed/wall/mineral/plastitanium,
/area/deathmatch)
"az" = (
/obj/machinery/door/airlock/hatch,
/turf/open/floor/carpet/neon/simple/lime,
/area/deathmatch)
"aA" = (
/obj/machinery/vending/cigarette,
/turf/open/floor/engine,
/area/deathmatch)
"aB" = (
/obj/machinery/vending/assist,
/turf/open/floor/engine,
/area/deathmatch)
"aC" = (
/obj/machinery/vending/sustenance,
/turf/open/floor/engine,
/area/deathmatch)
"aE" = (
/turf/open/floor/carpet/neon/simple/lime,
/area/deathmatch)
"aF" = (
/mob/living/carbon/human/species/monkey/angry,
/turf/open/floor/engine,
/area/deathmatch)
"aG" = (
/obj/item/chair,
/turf/open/floor/engine,
/area/deathmatch)
"aH" = (
/obj/item/mecha_parts/mecha_equipment/antiproj_armor_booster,
/turf/open/floor/engine,
/area/deathmatch)
"aI" = (
/obj/structure/showcase/machinery/cloning_pod,
/turf/open/floor/engine,
/area/deathmatch)
"aJ" = (
/turf/open/floor/carpet/neon/simple/red,
/area/deathmatch)
"aK" = (
/turf/open/floor/carpet/neon/simple/violet,
/area/deathmatch)
"aL" = (
/obj/structure/table_frame,
/turf/open/floor/carpet/neon/simple/violet,
/area/deathmatch)
"aM" = (
/obj/effect/decal/cleanable/blood/gibs,
/turf/open/floor/engine,
/area/deathmatch)
"aN" = (
/obj/structure/showcase/horrific_experiment,
/turf/open/floor/engine,
/area/deathmatch)
"aO" = (
/obj/effect/decal/cleanable/blood/drip,
/turf/open/floor/engine,
/area/deathmatch)
"aP" = (
/obj/machinery/door/airlock/hatch,
/turf/open/floor/engine,
/area/deathmatch)
"aQ" = (
/obj/structure/chair/office,
/turf/open/floor/engine,
/area/deathmatch)
"aR" = (
/obj/effect/decal/cleanable/blood/splatter,
/turf/open/floor/engine,
/area/deathmatch)
"aS" = (
/obj/structure/table,
/turf/open/floor/engine,
/area/deathmatch)
"aU" = (
/obj/structure/barricade/sandbags,
/turf/open/floor/engine,
/area/deathmatch)
"aV" = (
/obj/machinery/door/airlock/hatch,
/turf/open/floor/carpet/neon/simple/purple,
/area/deathmatch)
"aW" = (
/obj/structure/chair{
	dir = 1;
	icon_state = "chair"
	},
/turf/open/floor/engine,
/area/deathmatch)
"aY" = (
/obj/structure/table,
/turf/open/floor/carpet/neon/simple/violet,
/area/deathmatch)
"aZ" = (
/obj/structure/barricade/security,
/turf/open/floor/carpet/neon/simple/violet,
/area/deathmatch)
"ba" = (
/obj/structure/table,
/obj/item/mecha_parts/mecha_equipment/repair_droid,
/turf/open/floor/engine,
/area/deathmatch)
"bb" = (
/obj/structure/table/reinforced,
/obj/item/gun/energy/laser,
/turf/open/floor/engine,
/area/deathmatch)
"bc" = (
/obj/structure/table_frame,
/turf/open/floor/engine,
/area/deathmatch)
"bd" = (
/turf/open/floor/carpet/neon/simple/orange,
/area/deathmatch)
"be" = (
/obj/vehicle/sealed/mecha/combat/gygax,
/turf/open/floor/carpet/neon/simple/orange,
/area/deathmatch)
"bf" = (
/obj/vehicle/sealed/mecha/combat/gygax,
/turf/open/floor/carpet/neon/simple/teal,
/area/deathmatch)
"bh" = (
/obj/structure/table/reinforced,
/obj/item/clothing/head/welding,
/obj/item/inducer/sci,
/obj/item/weldingtool/largetank,
/turf/open/floor/carpet/neon/simple/orange,
/area/deathmatch)
"bi" = (
/obj/structure/barricade/security,
/turf/open/floor/carpet/neon/simple/red,
/area/deathmatch)
"bj" = (
/obj/structure/table,
/obj/item/storage/belt/janitor,
/turf/open/floor/engine,
/area/deathmatch)
"bk" = (
/obj/structure/table,
/obj/item/reagent_containers/glass/bucket,
/turf/open/floor/engine,
/area/deathmatch)
"bl" = (
/obj/structure/table,
/obj/item/mop,
/turf/open/floor/engine,
/area/deathmatch)
"bm" = (
/obj/structure/janitorialcart{
	dir = 4;
	icon_state = "cart"
	},
/turf/open/floor/engine,
/area/deathmatch)
"bn" = (
/obj/item/storage/bag/trash,
/turf/open/floor/engine,
/area/deathmatch)
"bo" = (
/obj/structure/closet/l3closet/janitor,
/turf/open/floor/engine,
/area/deathmatch)
"bp" = (
/obj/machinery/vending/wardrobe/jani_wardrobe,
/turf/open/floor/engine,
/area/deathmatch)
"bq" = (
/obj/machinery/door/poddoor/shutters{
	id_tag = "dm4"
	},
/turf/open/floor/engine,
/area/deathmatch)
"br" = (
/obj/structure/table/reinforced,
/obj/item/clothing/head/welding,
/obj/item/weldingtool,
/obj/item/inducer/sci,
/turf/open/floor/carpet/neon/simple/teal,
/area/deathmatch)
"bs" = (
/obj/structure/table/reinforced,
/obj/item/mecha_ammo/lmg,
/obj/item/mecha_ammo/lmg{
	pixel_y = 12
	},
/obj/item/mecha_ammo/scattershot{
	pixel_y = 18
	},
/obj/item/mecha_ammo/scattershot{
	pixel_y = 24
	},
/turf/open/floor/carpet/neon/simple/orange,
/area/deathmatch)
"bt" = (
/obj/structure/table/reinforced,
/obj/item/mecha_parts/mecha_equipment/weapon/ballistic/lmg{
	pixel_y = -8
	},
/obj/item/mecha_parts/mecha_equipment/weapon/ballistic/scattershot{
	pixel_y = 8
	},
/turf/open/floor/carpet/neon/simple/orange,
/area/deathmatch)
"bu" = (
/obj/machinery/button{
	id = null;
	id_tag = "dm1"
	},
/turf/open/floor/carpet/neon/simple/red,
/area/deathmatch)
"bv" = (
/obj/structure/table/reinforced,
/obj/item/mecha_parts/mecha_equipment/weapon/ballistic/lmg{
	pixel_y = -8
	},
/obj/item/mecha_parts/mecha_equipment/weapon/ballistic/scattershot{
	pixel_y = 8
	},
/turf/open/floor/carpet/neon/simple/teal,
/area/deathmatch)
"bw" = (
/obj/structure/table/reinforced,
/obj/item/mecha_ammo/lmg,
/obj/item/mecha_ammo/lmg{
	pixel_y = 12
	},
/obj/item/mecha_ammo/scattershot{
	pixel_y = 18
	},
/obj/item/mecha_ammo/scattershot{
	pixel_y = 24
	},
/turf/open/floor/carpet/neon/simple/teal,
/area/deathmatch)
"bx" = (
/obj/effect/landmark/deathmatch_player_spawn,
/obj/effect/turf_decal/box,
/turf/open/floor/carpet/neon/simple/yellow,
/area/deathmatch)
"by" = (
/obj/effect/landmark/deathmatch_player_spawn,
/obj/effect/turf_decal/box,
/turf/open/floor/carpet/neon/simple/green,
/area/deathmatch)
"bz" = (
/obj/effect/turf_decal/trimline/yellow/filled/warning,
/turf/open/floor/engine,
/area/deathmatch)
"bB" = (
/obj/effect/turf_decal/trimline/yellow/filled/warning{
	dir = 4;
	icon_state = "trimline_warn_fill"
	},
/turf/open/floor/engine,
/area/deathmatch)
"bC" = (
/obj/effect/turf_decal/trimline/yellow/filled/warning{
	dir = 8;
	icon_state = "trimline_warn_fill"
	},
/turf/open/floor/engine,
/area/deathmatch)
"bF" = (
/obj/effect/turf_decal/trimline/yellow/filled/warning{
	dir = 1;
	icon_state = "trimline_warn_fill"
	},
/turf/open/floor/engine,
/area/deathmatch)
"bG" = (
/obj/machinery/button{
	id_tag = "dm4"
	},
/turf/open/floor/carpet/neon/simple/purple,
/area/deathmatch)
"bH" = (
/obj/structure/reagent_dispensers/fueltank,
/turf/open/floor/engine,
/area/deathmatch)
"bJ" = (
/obj/structure/table/reinforced,
/obj/item/mecha_parts/mecha_equipment/weapon/energy/laser/heavy,
/turf/open/floor/engine,
/area/deathmatch)
"bL" = (
/obj/structure/reagent_dispensers/water_cooler,
/turf/open/floor/engine,
/area/deathmatch)
"bM" = (
/obj/structure/barricade/wooden,
/turf/open/floor/engine,
/area/deathmatch)
"bN" = (
/obj/machinery/door/airlock/hatch,
/turf/open/floor/carpet/neon/simple/teal,
/area/deathmatch)
"bO" = (
/obj/item/gun/energy/laser/hellgun,
/obj/structure/closet/crate/trashcart/filled,
/turf/open/floor/engine,
/area/deathmatch)
"bP" = (
/obj/machinery/stasis,
/turf/open/floor/engine,
/area/deathmatch)
"bR" = (
/turf/open/floor/carpet/neon/simple/teal,
/area/deathmatch)
"bS" = (
/obj/machinery/recharger,
/obj/structure/table,
/turf/open/floor/engine,
/area/deathmatch)
"bT" = (
/obj/structure/urinal{
	pixel_y = 24
	},
/turf/open/floor/noslip,
/area/deathmatch)
"bU" = (
/obj/structure/reagent_dispensers/cooking_oil,
/turf/open/floor/engine,
/area/deathmatch)
"bV" = (
/turf/open/floor/noslip,
/area/deathmatch)
"bW" = (
/obj/structure/toilet{
	dir = 8;
	icon_state = "toilet00"
	},
/turf/open/floor/light,
/area/deathmatch)
"bY" = (
/obj/machinery/sleeper{
	dir = 4;
	icon_state = "sleeper"
	},
/turf/open/floor/engine,
/area/deathmatch)
"bZ" = (
/obj/vehicle/ridden/atv,
/obj/item/key/atv,
/turf/open/floor/engine,
/area/deathmatch)
"ca" = (
/obj/machinery/sleeper{
	dir = 8;
	icon_state = "sleeper"
	},
/turf/open/floor/engine,
/area/deathmatch)
"cb" = (
/obj/item/grenade/smokebomb,
/turf/open/floor/engine,
/area/deathmatch)
"cc" = (
/obj/item/mecha_parts/mecha_equipment/anticcw_armor_booster,
/turf/open/floor/engine,
/area/deathmatch)
"cd" = (
/obj/structure/barricade/wooden,
/turf/open/floor/carpet/neon/simple/teal,
/area/deathmatch)
"ce" = (
/obj/machinery/vending/medical,
/turf/open/floor/engine,
/area/deathmatch)
"cg" = (
/obj/item/shard,
/turf/open/floor/engine,
/area/deathmatch)
"ch" = (
/obj/structure/table,
/obj/item/storage/briefcase,
/turf/open/floor/engine,
/area/deathmatch)
"ci" = (
/obj/structure/table,
/obj/item/storage/toolbox/mechanical,
/turf/open/floor/engine,
/area/deathmatch)
"ck" = (
/turf/open/floor/sepia,
/area/deathmatch)
"cl" = (
/obj/structure/cannon{
	dir = 8;
	icon_state = "falconet_patina"
	},
/turf/open/floor/sepia,
/area/deathmatch)
"cm" = (
/obj/structure/window/fulltile,
/turf/open/floor/engine,
/area/deathmatch)
"cn" = (
/obj/structure/window,
/turf/open/floor/sepia,
/area/deathmatch)
"co" = (
/obj/item/gun/ballistic/revolver/detective,
/obj/structure/table/wood,
/turf/open/floor/sepia,
/area/deathmatch)
"cp" = (
/obj/item/gun/ballistic/rifle/boltaction/pipegun,
/obj/structure/table/wood,
/turf/open/floor/sepia,
/area/deathmatch)
"cq" = (
/obj/item/gun/ballistic/rifle/boltaction,
/obj/structure/table/wood,
/turf/open/floor/sepia,
/area/deathmatch)
"cr" = (
/obj/structure/window{
	dir = 8;
	icon_state = "window"
	},
/obj/item/lighter,
/turf/open/floor/sepia,
/area/deathmatch)
"cs" = (
/obj/structure/closet/crate/trashcart/filled,
/obj/item/weldingtool,
/turf/open/floor/engine,
/area/deathmatch)
"ct" = (
/obj/structure/fermenting_barrel/gunpowder,
/turf/open/floor/sepia,
/area/deathmatch)
"cu" = (
/obj/item/stack/cannonball/fourteen,
/obj/structure/table/wood,
/turf/open/floor/sepia,
/area/deathmatch)
"cv" = (
/obj/structure/table,
/obj/structure/table,
/obj/item/grenade/smokebomb,
/turf/open/floor/engine,
/area/deathmatch)
"cw" = (
/obj/machinery/light/directional/east,
/turf/open/floor/engine,
/area/deathmatch)
"cx" = (
/obj/item/mecha_ammo/scattershot,
/turf/open/floor/engine,
/area/deathmatch)
"cy" = (
/obj/item/storage/firstaid/regular,
/turf/open/floor/noslip,
/area/deathmatch)
"cz" = (
/obj/structure/closet/crate/trashcart/filled,
/obj/machinery/light/directional/west,
/turf/open/floor/engine,
/area/deathmatch)
"cA" = (
/obj/structure/tank_holder/extinguisher,
/turf/open/floor/carpet/neon/simple/red,
/area/deathmatch)
"cB" = (
/obj/machinery/light/directional/north,
/turf/open/floor/engine,
/area/deathmatch)
"cC" = (
/obj/machinery/light/directional/south,
/turf/open/floor/carpet/neon/simple/teal,
/area/deathmatch)
"cD" = (
/obj/machinery/light/directional/west,
/turf/open/floor/engine,
/area/deathmatch)
"cE" = (
/obj/machinery/door/airlock/hatch,
/turf/open/floor/carpet/neon/simple/green,
/area/deathmatch)
"cF" = (
/obj/structure/barricade/wooden,
/turf/open/floor/carpet/neon/simple/green,
/area/deathmatch)
"cG" = (
/turf/open/floor/carpet/neon/simple/green,
/area/deathmatch)
"cH" = (
/obj/item/grenade/smokebomb,
/turf/open/floor/carpet/neon/simple/green,
/area/deathmatch)
"cI" = (
/obj/machinery/light/directional/north,
/turf/open/floor/sepia,
/area/deathmatch)
"cJ" = (
/turf/open/floor/light/colour_cycle/dancefloor_a,
/area/deathmatch)
"cK" = (
/obj/item/reagent_containers/pill/happinesspsych,
/turf/open/floor/light/colour_cycle/dancefloor_b,
/area/deathmatch)
"cL" = (
/obj/item/fireaxe,
/turf/open/floor/light/colour_cycle/dancefloor_a,
/area/deathmatch)
"cM" = (
/obj/item/reagent_containers/syringe,
/turf/open/floor/light/colour_cycle/dancefloor_b,
/area/deathmatch)
"cN" = (
/obj/item/reagent_containers/pill/lsd,
/turf/open/floor/light/colour_cycle/dancefloor_a,
/area/deathmatch)
"cO" = (
/obj/item/reagent_containers/pill/probital,
/turf/open/floor/light/colour_cycle/dancefloor_b,
/area/deathmatch)
"cP" = (
/obj/item/reagent_containers/glass/bucket/wooden,
/obj/machinery/light/directional/south,
/turf/open/floor/sepia,
/area/deathmatch)
"cQ" = (
/obj/item/reagent_containers/food/drinks/drinkingglass/filled/nuka_cola,
/turf/open/floor/light/colour_cycle/dancefloor_a,
/area/deathmatch)
"cR" = (
/obj/item/reagent_containers/pill/stimulant,
/turf/open/floor/light/colour_cycle/dancefloor_b,
/area/deathmatch)
"cS" = (
/obj/machinery/recharge_station,
/turf/open/floor/engine,
/area/deathmatch)
"cT" = (
/obj/machinery/sheetifier,
/turf/open/floor/engine,
/area/deathmatch)
"cU" = (
/obj/item/inducer,
/obj/item/weldingtool,
/turf/open/floor/engine,
/area/deathmatch)
"cV" = (
/obj/machinery/door/poddoor/shutters{
	id_tag = "dm2"
	},
/turf/open/floor/engine,
/area/deathmatch)
"cW" = (
/obj/machinery/grill,
/turf/open/floor/engine,
/area/deathmatch)
"cX" = (
/obj/machinery/door/poddoor/shutters{
	id_tag = "dm3"
	},
/turf/open/floor/engine,
/area/deathmatch)
"cY" = (
/obj/machinery/sheetifier,
/obj/machinery/light/directional/east,
/turf/open/floor/engine,
/area/deathmatch)
"cZ" = (
/obj/machinery/grill,
/obj/machinery/light/directional/west,
/turf/open/floor/engine,
/area/deathmatch)
"da" = (
/obj/structure/table,
/obj/item/food/meat/rawcutlet,
/turf/open/floor/engine,
/area/deathmatch)
"db" = (
/obj/machinery/button{
	id_tag = "dm2"
	},
/turf/open/floor/carpet/neon/simple/blue,
/area/deathmatch)
"dc" = (
/obj/effect/landmark/deathmatch_player_spawn,
/obj/effect/turf_decal/box,
/turf/open/floor/carpet/neon/simple/orange,
/area/deathmatch)
"dd" = (
/obj/structure/table,
/obj/item/food/meat/slab/pig,
/turf/open/floor/engine,
/area/deathmatch)
"de" = (
/obj/effect/landmark/deathmatch_player_spawn,
/obj/effect/turf_decal/box,
/turf/open/floor/carpet/neon/simple/teal,
/area/deathmatch)
"df" = (
/obj/machinery/button{
	id_tag = "dm3"
	},
/turf/open/floor/carpet/neon/simple/pink,
/area/deathmatch)
"dg" = (
/obj/structure/reagent_dispensers/watertank,
/obj/machinery/light/directional/south,
/turf/open/floor/engine,
/area/deathmatch)
"dh" = (
/obj/machinery/light/directional/south,
/turf/open/floor/engine,
/area/deathmatch)
"di" = (
/obj/structure/table,
/obj/item/food/meat/slab/bear,
/turf/open/floor/engine,
/area/deathmatch)
"dk" = (
/obj/effect/spawner/structure/window/reinforced,
/turf/open/floor/engine,
/area/deathmatch)
"Ij" = (
/turf/template_noop,
/area/template_noop)

(1,1,1) = {"
Ij
Ij
Ij
Ij
Ij
Ij
Ij
Ij
Ij
Ij
Ij
Ij
Ij
Ij
Ij
Ij
Ij
Ij
Ij
Ij
Ij
Ij
Ij
Ij
Ij
Ij
Ij
Ij
Ij
"}
(2,1,1) = {"
Ij
ac
ac
ac
ac
ac
ac
ac
ac
ac
ac
ac
ac
ac
ac
ac
ac
ac
ac
ac
ac
ac
ac
ac
ac
ac
ac
ac
Ij
"}
(3,1,1) = {"
Ij
ac
ad
ao
af
ag
aj
ax
cD
cm
aj
ax
bP
bY
bY
cc
ax
cD
aU
aj
ax
cS
cD
cV
bd
bh
bs
ac
Ij
"}
(4,1,1) = {"
Ij
ac
ae
bu
af
ac
aj
ax
aj
cm
bM
bN
cd
aj
aj
aj
ax
aj
aU
aj
ax
cS
aj
ac
bd
db
bt
ac
Ij
"}
(5,1,1) = {"
Ij
ac
af
bx
at
ac
aj
aP
aj
cm
aj
ax
bR
bR
bR
cC
ax
aj
aU
aj
ax
aj
aj
ac
be
dc
bd
ac
Ij
"}
(6,1,1) = {"
Ij
ac
ag
ac
ac
ac
aj
ax
aj
cm
aj
ax
cB
aj
aj
cd
cE
cF
cG
cG
cE
aj
aj
ac
ac
ac
cV
ac
Ij
"}
(7,1,1) = {"
Ij
ac
aj
aj
aj
aj
aj
ax
aj
cm
aj
ax
aj
bZ
aj
aj
ax
aj
cH
aj
ax
aj
aj
aj
aj
aj
aj
ac
Ij
"}
(8,1,1) = {"
Ij
ac
aj
aj
aj
aj
aj
ax
aj
cm
cw
ax
bS
ca
ca
ce
ax
aj
cG
cw
ax
aj
cT
cT
cY
aj
aj
ac
Ij
"}
(9,1,1) = {"
Ij
ac
ax
ax
aP
ax
ax
ax
ax
ax
ax
ax
ax
ax
ax
ax
ax
ax
cE
ax
ax
ax
ax
ax
ax
ax
aP
ac
Ij
"}
(10,1,1) = {"
Ij
ac
cA
aJ
aJ
aJ
aJ
aJ
aJ
aJ
aJ
cA
ax
aA
aj
cD
bL
aj
aK
aj
aj
cD
aj
aj
ax
bj
aj
ac
Ij
"}
(11,1,1) = {"
Ij
ac
aJ
ak
ak
ak
aj
aj
aj
aj
aj
aJ
ax
aB
aj
aK
aK
aK
aK
ak
ak
aY
ba
aj
ax
bk
aj
ac
Ij
"}
(12,1,1) = {"
Ij
ac
aJ
aj
bB
bB
aj
aj
bB
bB
aj
aJ
ax
aC
aj
aK
aj
aj
aj
aj
aj
aK
cv
aj
ax
bl
dg
ac
Ij
"}
(13,1,1) = {"
Ij
ac
aJ
bz
au
au
bF
bz
au
au
bF
aJ
dk
aj
aj
aK
aj
ch
aW
aj
aj
aK
aj
aj
ax
aj
aj
ac
Ij
"}
(14,1,1) = {"
Ij
ac
aJ
aj
bC
bC
aj
aj
bC
bC
aj
aJ
aV
aK
aK
aK
aQ
aS
aW
aj
aj
aK
aK
aK
aV
aj
aj
ac
Ij
"}
(15,1,1) = {"
Ij
ac
aJ
aj
aj
aj
aj
aj
aj
aj
ak
bi
dk
aj
ak
aK
aj
ci
aW
aj
aj
aK
aj
aj
ax
bm
aj
ac
Ij
"}
(16,1,1) = {"
Ij
ac
bi
ak
aj
aJ
aJ
aJ
aJ
aj
aj
aJ
ax
aj
ak
aK
aj
aj
aj
aj
aj
aZ
ak
aj
ax
bn
dh
ac
Ij
"}
(17,1,1) = {"
Ij
ac
aJ
aj
aj
aJ
bb
bJ
aJ
aj
aj
aJ
ax
aj
ak
aL
aK
aK
aK
aK
aK
aZ
bc
aG
ax
bo
aj
ac
Ij
"}
(18,1,1) = {"
Ij
ac
aJ
aj
aj
aJ
bH
bb
aJ
aj
aj
aJ
ax
aj
aG
cw
aj
aj
aK
aj
aj
cw
aj
cx
ax
bp
aj
ac
Ij
"}
(19,1,1) = {"
Ij
ac
aJ
aj
aj
aJ
aJ
aJ
aJ
aj
aj
aJ
ax
ax
ax
ax
ax
ax
aP
ax
ax
ax
ax
ax
ax
ax
aP
ac
Ij
"}
(20,1,1) = {"
Ij
ac
aJ
aj
aj
aj
aj
aj
aj
aj
aj
aJ
ax
aj
aH
aj
aj
ax
ck
cn
co
ax
bT
bV
bV
cy
bV
ac
Ij
"}
(21,1,1) = {"
Ij
ac
aJ
aj
bB
bB
aj
aj
bB
bB
aj
bi
ax
aj
aI
aI
aj
ax
ck
cn
cp
ax
bT
bW
bW
bV
bV
ac
Ij
"}
(22,1,1) = {"
Ij
ac
aJ
bz
au
au
bF
bz
au
au
bF
aJ
ax
aj
aj
aj
aF
ax
ck
cn
cq
ax
ax
ax
ax
ax
aP
ac
Ij
"}
(23,1,1) = {"
Ij
ac
aJ
aj
bC
bC
aj
aj
bC
bC
aj
aJ
ax
cb
aI
aI
aj
ax
cI
ck
cr
ax
bU
cW
cZ
aj
aj
ac
Ij
"}
(24,1,1) = {"
Ij
ac
aJ
ak
ak
ak
aj
aj
aj
aj
aj
aJ
az
aE
aE
aE
aE
az
ck
ck
ck
aP
aj
aj
aj
aj
aj
ac
Ij
"}
(25,1,1) = {"
Ij
ac
cA
aJ
aJ
aJ
aJ
aJ
aJ
aJ
aJ
cA
ax
aj
aF
aM
aj
ax
ck
ck
cP
ax
cU
aj
da
dd
di
ac
Ij
"}
(26,1,1) = {"
Ij
ac
ax
ax
aP
ax
ax
ax
ax
ax
ax
ax
ax
aj
aI
aN
aR
ax
cl
ck
ct
ax
ax
aP
ax
ax
ax
ac
Ij
"}
(27,1,1) = {"
Ij
ac
aj
aj
aj
aj
cD
aj
ax
cs
cz
bO
ax
aF
aj
aO
cg
ax
ck
ck
cu
ax
aj
aj
cD
aj
aj
ac
Ij
"}
(28,1,1) = {"
Ij
ac
bq
ac
ac
ac
aj
aj
aP
aj
aj
aj
ax
aj
aI
aI
aF
ax
ax
aP
ax
ax
aj
ac
ac
ac
cX
ac
Ij
"}
(29,1,1) = {"
Ij
ac
cG
by
aw
ac
aj
aj
ax
aj
aU
aj
ax
ax
ax
ax
ax
ax
cJ
cM
cQ
ax
aj
ac
bf
de
bR
ac
Ij
"}
(30,1,1) = {"
Ij
ac
am
bG
cG
ac
aj
aj
ax
aj
aU
aj
aj
aU
aj
aj
aj
aP
cK
cN
cR
ax
aj
ac
bR
df
bv
ac
Ij
"}
(31,1,1) = {"
Ij
ac
an
as
cG
bq
aj
aj
ax
aj
aU
aj
cw
aj
aj
aU
aj
ax
cL
cO
cN
aP
aj
cX
bR
br
bw
ac
Ij
"}
(32,1,1) = {"
Ij
ac
ac
ac
ac
ac
ac
ac
ac
ac
ac
ac
ac
ac
ac
ac
ac
ac
ac
ac
ac
ac
ac
ac
ac
ac
ac
ac
Ij
"}
(33,1,1) = {"
Ij
Ij
Ij
Ij
Ij
Ij
Ij
Ij
Ij
Ij
Ij
Ij
Ij
Ij
Ij
Ij
Ij
Ij
Ij
Ij
Ij
Ij
Ij
Ij
Ij
Ij
Ij
Ij
Ij
"}
