//MAP CONVERTED BY dmm2tgm.py THIS HEADER COMMENT PREVENTS RECONVERSION, DO NOT REMOVE
"a" = (
/turf/open/space/basic,
/area/template_noop)
"f" = (
/obj/machinery/light{
	dir = 1
	},
/turf/open/floor/wood,
/area/deathmatch)
"g" = (
/turf/closed/indestructible/iron,
/area/deathmatch)
"s" = (
/obj/effect/landmark/deathmatch_player_spawn,
/obj/effect/decal/cleanable/dirt/dust,
/turf/open/floor/wood,
/area/deathmatch)
"z" = (
/turf/open/floor/wood,
/area/deathmatch)
"B" = (
/obj/effect/landmark/deathmatch_player_spawn,
/turf/open/floor/wood,
/area/deathmatch)
"C" = (
/obj/machinery/light{
	dir = 8
	},
/obj/effect/decal/cleanable/dirt/dust,
/turf/open/floor/wood,
/area/deathmatch)
"K" = (
/turf/closed/wall,
/area/deathmatch)
"M" = (
/obj/effect/decal/cleanable/dirt/dust,
/turf/open/floor/wood,
/area/deathmatch)
"O" = (
/obj/structure/barricade/wooden,
/turf/open/floor/wood,
/area/deathmatch)
"T" = (
/obj/machinery/light{
	dir = 4
	},
/turf/open/floor/wood,
/area/deathmatch)
"W" = (
/obj/machinery/light{
	dir = 8
	},
/turf/open/floor/wood,
/area/deathmatch)
"X" = (
/obj/machinery/light,
/turf/open/floor/wood,
/area/deathmatch)

(1,1,1) = {"
a
a
a
a
g
g
g
g
g
g
g
a
a
a
a
a
a
a
a
a
a
a
"}
(2,1,1) = {"
a
a
a
a
g
z
z
C
M
z
g
a
a
a
g
g
g
g
g
g
g
a
"}
(3,1,1) = {"
a
a
a
a
g
z
z
M
O
O
g
a
a
a
g
z
z
z
z
z
g
a
"}
(4,1,1) = {"
a
a
a
a
g
z
z
z
z
z
g
a
a
a
g
B
z
O
O
z
g
a
"}
(5,1,1) = {"
a
a
a
a
g
B
z
O
M
z
g
a
a
a
g
z
z
z
M
X
g
a
"}
(6,1,1) = {"
g
g
g
g
g
z
z
O
z
z
g
a
a
a
g
z
M
O
M
z
g
a
"}
(7,1,1) = {"
g
z
z
z
O
O
O
O
z
O
g
g
g
g
g
O
M
O
z
M
g
a
"}
(8,1,1) = {"
g
M
z
M
z
z
z
z
M
z
z
W
z
O
z
z
M
O
z
z
g
a
"}
(9,1,1) = {"
g
z
z
z
O
M
M
z
z
z
M
M
M
M
z
z
M
g
g
g
g
a
"}
(10,1,1) = {"
g
f
s
M
O
z
O
O
O
z
z
O
z
z
z
z
z
g
a
a
a
a
"}
(11,1,1) = {"
g
z
z
z
O
M
M
K
M
M
K
K
K
z
O
O
X
g
a
a
a
a
"}
(12,1,1) = {"
g
z
O
z
M
M
M
K
z
M
M
M
z
z
O
M
M
g
a
a
a
a
"}
(13,1,1) = {"
g
z
O
z
O
O
O
K
z
z
z
z
M
z
O
z
M
g
g
g
g
g
"}
(14,1,1) = {"
g
z
z
z
z
M
z
O
M
M
O
K
K
K
M
M
M
O
z
z
z
g
"}
(15,1,1) = {"
g
g
g
g
g
f
z
z
z
z
M
z
z
z
z
O
O
O
z
z
z
g
"}
(16,1,1) = {"
a
a
a
a
g
z
z
O
O
O
z
M
z
O
z
T
M
M
z
O
z
g
"}
(17,1,1) = {"
a
a
a
a
g
M
M
z
M
M
z
z
z
O
g
g
g
z
B
O
z
g
"}
(18,1,1) = {"
a
a
a
a
g
O
z
M
z
z
z
M
z
z
g
a
g
z
M
M
X
g
"}
(19,1,1) = {"
a
a
a
a
g
z
z
O
O
O
O
z
M
M
g
a
g
z
M
z
M
g
"}
(20,1,1) = {"
a
a
a
a
g
z
M
M
z
z
z
z
z
z
g
a
g
z
z
z
z
g
"}
(21,1,1) = {"
a
a
a
a
g
z
z
M
B
T
O
z
z
z
g
a
g
g
g
g
g
g
"}
(22,1,1) = {"
a
a
a
a
g
g
g
g
g
g
g
g
g
g
g
a
a
a
a
a
a
a
"}
